00001000000000011111
00001000000000010001
00001111111000010001
00000000001111110001
00001111110000001111
00001000011111111000
00001000000000000000
00001000000000000000
00001111111111111111
00000000000000000001
00001111111111111111
00001000000000000000
00001000000000000000
00001000000000000000
00001111111111111111
00000000000000000001
00000000000000111111
00000000000000100000
00000000000000100000
00000000000000100000